+--+--+--+--+--+--+--+--+--+--+--+--+--+--+
|                 |                       |
+  +--+--+  +--+  +  +--+--+--+  +--+--+  +
|     |     |  |     |        |  |     |  |
+--+  +--+  +  +  +--+  +--+  +  +  +  +  +
|  |     |     |     |     |     |  |  |  |
+  +  +  +--+  +  +  +--+  +--+  +  +  +  +
|  |  |     |     |     |  |     |  |     |
+  +  +  +  +  +--+--+  +  +  +--+  +--+  +
|     |  |  |  |        |     |        |  |
+  +--+  +  +  +--+  +--+  +--+--+  +  +  +
|        |     |     |  |     |     |     |
+  +  +--+  +--+  +  +  +--+  +  +--+  +  +
|  |  |     |     |     |  |  |     |  |  |
+--+  +--+  +  +--+--+  +  +  +  +--+  +--+
|     |     |        |     |     |        |
+--+--+--+--+--+--+--+--+--+--+--+--+--+--+
